date,publication_date,dosen_kumulativ,personen_erst_kumulativ,personen_voll_kumulativ,dosen_biontech_kumulativ,dosen_erst_biontech_kumulativ,dosen_voll_biontech_kumulativ,dosen_moderna_kumulativ,dosen_erst_moderna_kumulativ,dosen_voll_moderna_kumulativ,dosen_astrazeneca_kumulativ,dosen_erst_astrazeneca_kumulativ,dosen_voll_astrazeneca_kumulativ,indikation_alter_dosen,indikation_alter_erst,indikation_alter_voll,indikation_beruf_dosen,indikation_beruf_erst,indikation_beruf_voll,indikation_medizinisch_dosen,indikation_medizinisch_erst,indikation_medizinisch_voll,indikation_pflegeheim_dosen,indikation_pflegeheim_erst,indikation_pflegeheim_voll,dosen_differenz_zum_vortag,dosen_erst_differenz_zum_vortag,dosen_voll_differenz_zum_vortag,impf_quote_dosen,impf_quote_erst,impf_quote_voll,impf_inzidenz_dosen,impf_inzidenz_erst,impf_inzidenz_voll
2020-12-27,2020-12-28 16:15,590,590,0,590,590,0,0,0,0,0,0,0,0,,0,240,240,0,0,,0,350,350,0,,,,0.03668839365775823,0.03668839365775823,0,0.3668839365775823,0.3668839365775823,0
2020-12-28,2020-12-29 08:00,4170,4170,0,4170,4170,0,0,0,0,0,0,0,100,100,0,1862,1862,0,2,2,0,2209,2209,0,3488,,,0.25930610432686746,0.25930610432686746,0,2.5930610432686745,2.5930610432686745,0
2020-12-30,2020-12-31 08:30,11101,11101,0,11101,11101,0,0,0,0,0,0,0,173,173,0,6349,6349,0,7,7,0,4651,4651,0,3640,,,0.6903014542284307,0.6903014542284307,0,6.903014542284306,6.903014542284306,0
2020-12-31,2021-01-01 12:30,11494,11494,0,11494,11494,0,0,0,0,0,0,0,178,178,0,6583,6583,0,8,8,0,4804,4804,0,393,,,0.7147396554275814,0.7147396554275814,0,7.147396554275814,7.147396554275814,0
2021-01-01,2021-01-02 08:00,11494,11494,0,11494,11494,0,0,0,0,0,0,0,178,178,0,6583,6583,0,8,8,0,4804,4804,0,,,,0.7147396554275814,0.7147396554275814,0,7.147396554275814,7.147396554275814,0
2021-01-02,2021-01-03 08:00,11494,11494,0,11494,11494,0,0,0,0,0,0,0,178,178,0,6583,6583,0,8,8,0,4804,4804,0,,,,0.7147396554275814,0.7147396554275814,0,7.147396554275814,7.147396554275814,0
2021-01-03,2021-01-04 12:00,11494,11494,0,11494,11494,0,0,0,0,0,0,0,178,178,0,6583,6583,0,8,8,0,4804,4804,0,,,,0.7147396554275814,0.7147396554275814,0,7.147396554275814,7.147396554275815,0
2021-01-04,2021-01-05 12:00,13832,13832,0,13832,13832,0,0,0,0,0,0,0,242,242,0,7738,7738,0,29,29,0,5968,5968,0,1773,,,0.8601251882612064,0.8601251882612064,0,8.601251882612065,8.601251882612065,0
2021-01-05,2021-01-06 11:00,18014,18014,0,18014,18014,0,0,0,0,0,0,0,456,456,0,10024,10024,0,27,27,0,7828,7828,0,2570,,,1.120177497204842,1.120177497204842,0,11.201774972048419,11.201774972048419,0
2021-01-06,2021-01-07 11:00,21713,21713,0,21713,21713,0,0,0,0,0,0,0,811,811,0,11746,11746,0,46,46,0,9712,9712,0,2359,,,1.3501950703235668,1.3501950703235668,0,13.501950703235668,13.501950703235668,0
2021-01-07,2021-01-08 11:00,24060,24060,0,24060,24060,0,0,0,0,0,0,0,1260,1260,0,12515,12515,0,137,137,0,11130,11130,0,1792,,,1.4961402566197677,1.4961402566197677,0,14.961402566197677,14.961402566197677,0
2021-01-08,2021-01-09 11:00,25141,25141,0,25141,25141,0,0,0,0,0,0,0,1473,1473,0,13122,13122,0,194,194,0,11541,11541,0,779,,,1.5633608558469485,1.5633608558469485,0,15.633608558469485,15.633608558469486,0
2021-01-10,2021-01-11 11:00,25141,25141,0,25141,25141,0,0,0,0,0,0,0,1473,1473,0,13122,13122,0,194,194,0,11541,11541,0,0,,,1.5633608558469485,1.5633608558469485,0,15.633608558469485,15.633608558469486,0
2021-01-11,2021-01-12 11:00,26926,26926,0,26926,26926,0,0,0,0,0,0,0,1596,1596,0,13895,13895,0,342,342,0,12311,12311,0,1553,,,1.6743587925911831,1.6743587925911831,0,16.743587925911832,16.743587925911832,0
2021-01-12,2021-01-13 11:00,29100,29100,0,29100,29100,0,0,0,0,0,0,0,2076,2076,0,14928,14928,0,376,376,0,13031,13031,0,2059,,,1.8095461956623127,1.8095461956623127,0,18.095461956623126,18.095461956623126,0
2021-01-13,2021-01-14 11:00,32998,32998,0,32998,32998,0,0,0,0,0,0,0,2516,2516,0,16644,16644,0,552,552,0,14696,14696,0,2284,,,2.0519383286757726,2.0519383286757726,0,20.51938328675773,20.519383286757726,0
2021-01-14,2021-01-15 11:00,35355,35355,0,35355,35355,0,0,0,0,0,0,0,2976,2976,0,17272,17272,0,591,591,0,15315,15315,0,2357,,,2.1985053521526137,2.1985053521526137,0,21.985053521526137,21.98505352152614,0
2021-01-15,2021-01-16 11:00,37570,37570,0,37570,37570,0,0,0,0,0,0,0,3454,3454,0,18238,18238,0,706,706,0,15991,15991,0,1140,,,2.336242287664367,2.336242287664367,0,23.36242287664367,23.36242287664367,0
2021-01-17,2021-01-18 11:00,37564,37564,0,37444,37444,0,120,120,0,0,0,0,3452,3452,0,18238,18238,0,706,706,0,15987,15987,0,,0,0,2.335869185355983,2.335869185355983,0,23.358691853559833,23.358691853559833,0
2021-01-18,2021-01-19 14:00,40273,39116,1157,39902,38745,1157,371,371,0,0,0,0,4022,3783,239,18986,18632,354,743,730,13,17093,16540,553,,1420,1157,2.504324877591351,2.432378315791307,0.07194656180004452,25.04324877591351,24.323783157913066,0.7194656180004453
2021-01-19,2021-01-20 10:00,42206,41827,379,41718,41339,379,488,488,0,0,0,0,4601,4601,0,19764,19680,84,836,836,0,17621,17326,295,,2310,0,2.624526004609057,2.600958375462802,0.023567629146254862,26.24526004609057,26.00958375462802,0.23567629146254862
2021-01-20,2021-01-21 10:00,47466,44449,3017,46863,43846,3017,603,603,0,0,0,0,5817,5443,374,21873,20683,1190,906,889,17,19547,18071,1476,,2621,1316,2.9516123616256813,2.7640040842266025,0.18760827739907893,29.516123616256813,27.640040842266025,1.8760827739907893
2021-01-21,2021-01-22 10:00,50769,47197,3572,50092,46520,3572,677,677,0,0,0,0,6959,6577,382,22893,21490,1403,980,959,21,20657,18851,1806,,2433,483,3.1570051823910634,2.9348849414664664,0.22212024092459726,31.570051823910635,29.348849414664663,2.2212024092459726
2021-01-22,2021-01-23 10:00,53548,49922,3626,52587,48961,3626,961,961,0,0,0,0,8053,7671,382,23872,22469,1403,1037,1016,21,21296,19490,1806,,2212,54,3.329813734890911,3.104335573190858,0.2254781617000531,33.29813734890911,31.04335573190858,2.254781617000531
2021-01-24,2021-01-25 10:00,53688,49946,3742,52727,48985,3742,961,961,0,0,0,0,8059,7671,388,23944,22486,1458,1037,1016,21,21412,19497,1915,,0,0,3.3385194554198705,3.105827982424394,0.23269147299547677,33.385194554198705,31.05827982424394,2.3269147299547677
2021-01-25,2021-01-26 10:00,57008,51199,5809,55946,50137,5809,1062,1062,0,0,0,0,8785,8183,602,25666,23037,2629,1051,1025,26,22284,19671,2613,,1145,1909,3.5449693993923406,3.1837441811585823,0.3612252182337585,35.449693993923404,31.837441811585823,3.6122521823375853
2021-01-26,2021-01-27 10:00,62212,52331,9881,60882,51001,9881,1330,1330,0,0,0,0,9484,8722,762,29169,23520,5649,1177,1093,84,23298,19778,3520,,805,3920,3.868573468197381,3.2541361500070267,0.6144373181903543,38.68573468197381,32.541361500070266,6.144373181903543
2021-01-27,2021-01-28 10:00,66337,53619,12718,64835,52117,12718,1502,1502,0,0,0,0,10639,9545,1094,31194,23797,7397,1278,1130,148,24247,19954,4293,,1042,2371,4.125081305211369,3.334228778873455,0.7908525263379138,41.250813052113685,33.34228778873455,7.908525263379138
2021-01-28,2021-01-29 10:00,69294,54907,14387,67629,53242,14387,1665,1665,0,0,0,0,11289,9976,1313,25149,24278,871,1144,1144,0,20161,20161,0,,1189,1668,4.308958559526608,3.414321407739883,0.8946371517867248,43.08958559526608,34.14321407739883,8.946371517867247
2021-01-29,2021-01-30 10:00,71235,56274,14961,69570,54609,14961,1665,1665,0,0,0,0,11877,10559,1318,25755,24768,987,1205,1205,0,20395,20395,0,,1276,451,4.429657156288826,3.499326550333367,0.930330605955459,44.29657156288826,34.99326550333367,9.30330605955459
2021-01-31,2021-02-01 10:00,71322,56289,15033,69657,54624,15033,1665,1665,0,0,0,0,11877,10559,1318,25764,24777,987,1205,1205,0,20401,20401,0,,0,0,4.435067139760394,3.5002593061043266,0.9348078336560668,44.35067139760394,35.00259306104327,9.348078336560668
2021-02-01,2021-02-02 10:00,73909,57239,16670,72178,55508,16670,1731,1731,0,0,0,0,12269,10839,1430,34890,25234,9656,1402,1251,151,26384,20627,5757,,802,1078,4.595936418391954,3.559333838265124,1.03660258012683,45.95936418391954,35.59333838265124,10.366025801268298
2021-02-02,2021-02-03 10:00,75926,58003,17923,74195,56272,17923,1731,1731,0,0,0,0,12566,11025,1541,35938,25561,10377,1406,1253,153,27122,20869,6253,,762,1197,4.721360977727036,3.6068421988660178,1.1145187788610182,47.21360977727036,36.06842198866018,11.145187788610182
2021-02-03,2021-02-04 10:00,78179,59064,19115,76427,57333,19094,1752,1731,21,0,0,0,13407,11796,1611,36783,25782,11001,1411,1255,156,27742,20937,6805,,1001,1144,4.861460894525221,3.6728191237319185,1.1886417707933026,48.61460894525221,36.72819123731919,11.886417707933026
2021-02-04,2021-02-05 10:00,80542,60083,20459,78811,58352,20459,1731,1731,0,0,0,0,13931,12264,1667,37983,26152,11831,1412,1256,156,28387,21117,7270,,962,1157,5.008401020310446,3.736184332439132,1.2722166878713146,50.08401020310446,37.361843324391316,12.722166878713145
2021-02-05,2021-02-06 10:00,82540,61425,21115,80809,59694,21115,1731,1731,0,0,0,0,14409,12727,1682,38967,26657,12310,1429,1271,158,28937,21498,7439,,1220,393,5.132644089002312,3.8196348820810155,1.3130092069212966,51.32644089002312,38.19634882081015,13.130092069212965
2021-02-07,2021-02-08 11:00,82540,61425,21115,80809,59694,21115,1731,1731,0,0,0,0,14409,12727,1682,38967,26657,12310,1429,1271,158,28937,21498,7439,,0,0,5.132644089002312,3.8196348820810155,1.3130092069212966,51.32644089002312,38.19634882081015,13.130092069212965
2021-02-08,2021-02-09 10:00,85709,62204,23505,83950,60445,23505,1759,1759,0,0,0,0,14754,13022,1732,41039,27051,13988,1458,1288,170,29704,21569,8135,,529,1455,5.3297042915471184,3.868075998452869,1.4616282930942495,53.29704291547119,38.68075998452869,14.616282930942493
2021-02-09,2021-02-10 10:00,89006,62865,26141,87247,61106,26141,1759,1759,0,0,0,0,15512,13381,2131,42469,27230,15239,1520,1290,230,30830,21696,9134,,668,2619,5.534724010004116,3.9091794360931713,1.6255445739109455,55.34724010004116,39.09179436093171,16.255445739109454
2021-02-10,2021-02-11 10:00,93200,64308,28892,91441,62549,28892,1759,1759,0,0,0,0,16661,14268,2393,44056,27534,16522,1631,1299,332,32196,21944,10252,,1391,2654,5.79552252356452,3.998910541259519,1.7966119823050013,57.9552252356452,39.98910541259519,17.96611982305001
2021-02-11,2021-02-12 10:00,92448,60805,31643,90329,58790,31539,1466,1362,104,653,653,0,16950,13936,3014,45511,27730,17781,1786,1408,378,30399,19361,11038,,1173,2432,5.748760367580394,3.7810809768813374,1.967679390699057,57.48760367580394,37.81080976881337,19.676793906990568
2021-02-12,2021-02-13 08:00,95294,62198,33096,92353,59478,32875,1677,1456,221,1264,1264,0,17691,14342,3349,47010,28551,18459,1847,1450,397,30956,19484,11472,,1392,1403,5.92573522919053,3.867702896144485,2.0580323330460444,59.2573522919053,38.677028961444854,20.580323330460445
2021-02-14,2021-02-15 08:00,95332,62232,33100,92359,59480,32879,1677,1456,221,1296,1296,0,17690,14341,3349,47049,28586,18463,1848,1451,397,30955,19483,11472,,0,0,5.9280982104769615,3.869817142558661,2.0582810679183003,59.28098210476961,38.69817142558661,20.582810679183005
2021-02-15,2021-02-16 08:00,97967,63400,34567,94485,60242,34243,1953,1629,324,1529,1529,0,18604,14760,3844,48010,29060,18950,1881,1474,407,31793,19740,12053,,1064,1448,6.0919523075755935,3.9424477252574093,2.149504582318184,60.91952307575593,39.42447725257409,21.49504582318184
2021-02-16,2021-02-17 10:00,101618,64738,36880,97593,61160,36433,2177,1730,447,1848,1848,0,19862,15364,4498,49257,29526,19731,1910,1478,432,32993,20090,12903,,1275,2242,6.318985062227247,4.025649540027038,2.293335522200209,63.189850622272466,40.256495400270374,22.933355222002092
2021-02-17,2021-02-18 08:00,105008,66232,38776,100544,62322,38222,2453,1899,554,2011,2011,0,21620,16426,5194,50177,29788,20389,1976,1524,452,33788,20354,13434,,1314,1853,6.529787866464196,4.118552014814649,2.4112358516495473,65.29787866464197,41.18552014814649,24.112358516495476
2021-02-18,2021-02-19 08:00,108606,67411,41195,103724,63154,40570,2705,2080,625,2177,2177,0,23375,17025,6350,51214,30102,21112,2018,1533,485,34558,20610,13948,,1007,2407,6.753524884058458,4.191866618412102,2.5616582656463565,67.53524884058457,41.918666184121015,25.616582656463564
2021-02-19,2021-02-20 08:00,112054,68414,43640,106575,63764,42811,3302,2473,829,2177,2177,0,24973,17593,7380,52341,30278,22063,2080,1553,527,35283,20880,14403,,998,2394,6.967934343943119,4.25423688763029,2.7136974563128287,69.6793434394312,42.5423688763029,27.136974563128287
2021-02-21,2021-02-22 08:00,112081,68418,43663,106602,63768,42834,3302,2473,829,2177,2177,0,24974,17593,7381,52358,30281,22077,2080,1553,527,35292,20881,14411,,0,0,6.9696133043308475,4.254485622502546,2.7151276818283008,69.69613304330848,42.54485622502546,27.15127681828301
2021-02-22,2021-02-23 08:00,115285,70450,44835,109187,65224,43963,3729,2857,872,2369,2369,0,26172,18447,7725,53739,30973,22766,2094,1559,535,35941,21391,14550,,1573,908,7.168849937007893,4.3808429376085884,2.7880069993993053,71.68849937007893,43.80842937608588,27.880069993993054
2021-02-23,2021-02-24 08:00,118433,72467,45966,111965,66913,45052,3869,2955,914,2599,2599,0,27563,19532,8031,54705,31409,23296,2109,1566,543,36736,21897,14839,,1888,1000,7.3646042814733566,4.5062674969436705,2.858336784529686,73.64604281473356,45.0626749694367,28.58336784529686
2021-02-24,2021-02-25 08:00,121482,74504,46978,114691,68704,45987,4066,3075,991,2725,2725,0,29619,20937,8682,55244,31733,23511,2148,1591,557,37157,22184,14973,,2043,1014,7.554202437850483,4.632935730640033,2.921266707210451,75.54202437850483,46.32935730640032,29.21266707210451
2021-02-25,2021-02-26 10:00,124901,77222,47679,117550,70989,46561,4255,3137,1118,3096,3096,0,31360,22334,9026,56014,32295,23719,2157,1593,564,38052,22939,15113,,2501,646,7.766808569911289,4.801951076337976,2.9648574935733127,77.6680856991129,48.019510763379756,29.648574935733127
2021-02-26,2021-02-27 08:00,128499,79502,48997,120151,72272,47879,4310,3192,1118,4038,4038,0,32997,23316,9681,57655,33417,24238,2186,1615,571,38613,23289,15324,,2171,1229,7.99054558750555,4.943729953523889,3.046815633981661,79.9054558750555,49.43729953523889,30.46815633981661
2021-02-28,2021-03-01 08:00,128498,79501,48997,120150,72271,47879,4310,3192,1118,4038,4038,0,32997,23316,9681,57654,33416,24238,2186,1615,571,38613,23289,15324,,0,0,7.990483403787486,4.943667769805825,3.046815633981661,79.90483403787486,49.436677698058254,30.46815633981661
2021-03-01,2021-03-02 08:00,130948,81006,49942,121900,73141,48759,4452,3269,1183,4596,4596,0,34093,24045,10048,58697,34080,24617,2277,1644,633,38990,23441,15549,,1460,880,8.142833513044279,5.037254265492141,3.105579247552138,81.42833513044279,50.3725426549214,31.05579247552138
2021-03-02,2021-03-03 10:00,134565,83959,50606,124371,74951,49420,4933,3747,1186,5261,5261,0,36219,25925,10294,59768,34927,24841,2353,1717,636,39593,23778,15815,,2933,667,8.367752021281756,5.220882784935124,3.1468692363466317,83.67752021281756,52.20882784935124,31.46869236346632
2021-03-03,2021-03-04 08:00,139042,87249,51793,127258,76652,50606,6007,4820,1187,5777,5777,0,39518,28343,11175,60718,35630,25088,2468,1806,662,39951,24024,15927,,3256,1110,8.64614852705427,5.425467217365674,3.2206813096885964,86.4614852705427,54.254672173656736,32.206813096885966
