date,publication_date,dosen_kumulativ,personen_erst_kumulativ,personen_voll_kumulativ,dosen_biontech_kumulativ,dosen_erst_biontech_kumulativ,dosen_voll_biontech_kumulativ,dosen_moderna_kumulativ,dosen_erst_moderna_kumulativ,dosen_voll_moderna_kumulativ,dosen_astrazeneca_kumulativ,dosen_erst_astrazeneca_kumulativ,dosen_voll_astrazeneca_kumulativ,indikation_alter_dosen,indikation_alter_erst,indikation_alter_voll,indikation_beruf_dosen,indikation_beruf_erst,indikation_beruf_voll,indikation_medizinisch_dosen,indikation_medizinisch_erst,indikation_medizinisch_voll,indikation_pflegeheim_dosen,indikation_pflegeheim_erst,indikation_pflegeheim_voll,dosen_differenz_zum_vortag,dosen_erst_differenz_zum_vortag,dosen_voll_differenz_zum_vortag,impf_quote_dosen,impf_quote_erst,impf_quote_voll,impf_inzidenz_dosen,impf_inzidenz_erst,impf_inzidenz_voll
2020-12-27,2020-12-28 16:15,21566,21566,0,21566,21566,0,0,0,0,0,0,0,5833,5833,0,7618,7618,0,962,962,0,11646,11646,0,1357,,,0.025931048301284874,0.025931048301284874,0,0.25931048301284876,0.25931048301284876,0
2020-12-28,2020-12-29 08:00,41962,41962,0,41962,41962,0,0,0,0,0,0,0,12232,12232,0,14964,14964,0,1661,1661,0,21767,21767,0,19084,,,0.05045528372523954,0.05045528372523954,0,0.5045528372523954,0.5045528372523954,0
2020-12-30,2020-12-31 08:30,131626,131626,0,131626,131626,0,0,0,0,0,0,0,31250,31250,0,61612,61612,0,3827,3827,0,57406,57406,0,51465,,,0.15826765110381724,0.15826765110381724,0,1.5826765110381724,1.5826765110381724,0
2020-12-31,2021-01-01 12:30,165575,165575,0,165575,165575,0,0,0,0,0,0,0,39214,39214,0,77253,77253,0,5355,5355,0,71590,71590,0,31846,,,0.19908807022559782,0.19908807022559782,0,1.9908807022559785,1.9908807022559785,0
2021-01-01,2021-01-02 08:00,188553,188553,0,188553,188553,0,0,0,0,0,0,0,44552,44552,0,86692,86692,0,6122,6122,0,82965,82965,0,21087,,,0.22671691321302823,0.22671691321302823,0,2.2671691321302823,2.2671691321302823,0
2021-01-02,2021-01-03 08:00,238809,238809,0,238809,238809,0,0,0,0,0,0,0,56197,56197,0,107019,107019,0,7317,7317,0,103894,103894,0,40665,,,0.28714493711311967,0.28714493711311967,0,2.871449371131197,2.871449371131197,0
2021-01-03,2021-01-04 12:00,265986,265986,0,265986,265986,0,0,0,0,0,0,0,62805,62805,0,123103,123103,0,7999,7999,0,114654,114654,0,22892,,,0.3198226752047463,0.3198226752047463,0,3.198226752047463,3.1982267520474625,0
2021-01-04,2021-01-05 12:00,316962,316962,0,316962,316962,0,0,0,0,0,0,0,73734,73734,0,149727,149727,0,10216,10216,0,131885,131885,0,44563,,,0.3811164301062717,0.3811164301062717,0,3.811164301062717,3.8111643010627176,0
2021-01-05,2021-01-06 11:00,367331,367331,0,367331,367331,0,0,0,0,0,0,0,84867,84867,0,176125,176125,0,12268,12268,0,150098,150098,0,45233,,,0.4416803256774216,0.4416803256774216,0,4.416803256774216,4.416803256774216,0
2021-01-06,2021-01-07 11:00,417060,417060,0,417060,417060,0,0,0,0,0,0,0,94997,94997,0,201540,201540,0,14732,14732,0,168564,168564,0,46332,,,0.5014746825806301,0.5014746825806301,0,5.014746825806301,5.014746825806301,0
2021-01-07,2021-01-08 11:00,476959,476959,0,476959,476959,0,0,0,0,0,0,0,109314,109314,0,232473,232473,0,17267,17267,0,188746,188746,0,50938,,,0.5734974898790935,0.5734974898790935,0,5.734974898790936,5.734974898790936,0
2021-01-08,2021-01-09 11:00,532878,532878,0,532878,532878,0,0,0,0,0,0,0,122622,122622,0,261536,261536,0,20043,20043,0,206772,206772,0,50066,,,0.640734728586297,0.640734728586297,0,6.407347285862969,6.407347285862969,0
2021-01-10,2021-01-11 11:00,613347,613347,0,613347,613347,0,0,0,0,0,0,0,144648,144648,0,296755,296755,0,22159,22159,0,238053,238053,0,28221,,,0.7374909896340617,0.7374909896340617,0,7.3749098963406166,7.3749098963406166,0
2021-01-11,2021-01-12 11:00,688782,688782,0,688782,688782,0,0,0,0,0,0,0,166335,166335,0,330613,330613,0,25372,25372,0,262219,262219,0,60858,,,0.8281943480968004,0.8281943480968004,0,8.281943480968003,8.281943480968005,0
2021-01-12,2021-01-13 11:00,758093,758093,0,758093,758093,0,0,0,0,0,0,0,186984,186984,0,366029,366029,0,28125,28125,0,285023,285023,0,69178,,,0.9115341834306757,0.9115341834306757,0,9.115341834306758,9.115341834306758,0
2021-01-13,2021-01-14 11:00,842455,842455,0,842455,842455,0,0,0,0,0,0,0,207992,207992,0,408585,408585,0,29949,29949,0,308886,308886,0,78116,,,1.0129714039070272,1.0129714039070272,0,10.129714039070272,10.12971403907027,0
2021-01-14,2021-01-15 11:00,961682,961682,0,961682,961682,0,0,0,0,0,0,0,231921,231921,0,468813,468813,0,32095,32095,0,341768,341768,0,94654,,,1.15633044572365,1.15633044572365,0,11.563304457236502,11.563304457236502,0
2021-01-15,2021-01-16 11:00,1048160,1048160,0,1048160,1048160,0,0,0,0,0,0,0,255415,255415,0,514710,514710,0,34600,34600,0,366228,366228,0,79759,,,1.2603119534208826,1.2603119534208826,0,12.603119534208826,12.603119534208826,0
2021-01-17,2021-01-18 11:00,1145878,1139297,6581,1143154,1136573,6581,2724,2724,0,0,0,0,282002,279063,2939,553481,551369,2112,39379,39012,367,399037,394516,4521,,31152,6464,1.3778084839738343,1.3698954621398938,0.007913021833940265,13.778084839738343,13.69895462139894,0.07913021833940265
2021-01-18,2021-01-19 14:00,1220284,1195543,24741,1207954,1183213,24741,12330,12330,0,0,0,0,305468,299576,5892,585039,576794,8245,38117,37687,430,418626,407835,10791,,49289,12594,1.4672745685470236,1.4375258870102487,0.02974868153677497,14.672745685470236,14.375258870102487,0.29748681536774974
2021-01-19,2021-01-20 10:00,1297430,1254760,42670,1282216,1239546,42670,15214,15214,0,0,0,0,330438,319234,11204,621803,603359,18444,40729,39814,915,440513,422913,17600,,54341,17983,1.5600352405423368,1.508728654665687,0.051306585876649616,15.600352405423367,15.087286546656872,0.5130658587664961
2021-01-20,2021-01-21 10:00,1401693,1324091,77602,1385365,1307763,77602,16328,16328,0,0,0,0,360436,343506,16930,672029,633501,38528,43489,42061,1428,472402,441484,30918,,64777,32164,1.685401506379157,1.5920925380829356,0.0933089682962213,16.854015063791568,15.920925380829356,0.9330896829622131
2021-01-21,2021-01-22 10:00,1501639,1386464,115175,1483549,1368374,115175,18090,18090,0,0,0,0,420178,391157,29021,673286,620102,53184,52850,49139,3711,515815,470128,45687,,54988,31528,1.8055769934198793,1.6670900932946597,0.13848690012521958,18.055769934198793,16.670900932946598,1.3848690012521958
2021-01-22,2021-01-23 10:00,1632777,1469353,163424,1614485,1451061,163424,19651,19651,0,0,0,0,456933,419138,37795,720183,653041,67142,55165,50924,4241,557621,497963,59658,,79301,27435,1.9632578712893913,1.7667561724305774,0.19650169885881383,19.632578712893913,17.667561724305774,1.9650169885881383
2021-01-24,2021-01-25 10:00,1783118,1554355,228763,1764567,1535804,228763,20351,20351,0,0,0,0,473601,420236,53365,831196,733379,97817,53665,48521,5144,596510,509734,86776,,35023,26025,2.1440285164096484,1.8689629315748701,0.27506558483477844,21.440285164096487,18.6896293157487,2.750655848347784
2021-01-25,2021-01-26 10:00,1921689,1638425,283264,1891378,1608114,283264,30311,30311,0,0,0,0,556666,476690,79976,914916,777538,137378,57500,50510,6990,635925,525015,110910,,52743,35867,2.3106468644647977,1.9700490500339733,0.3405978144308244,23.106468644647975,19.700490500339733,3.4059781443082437
2021-01-26,2021-01-27 10:00,1990889,1672215,318674,1967228,1648554,318674,23661,23661,0,0,0,0,592618,502165,90453,939329,776907,162422,60470,51418,9052,663171,537297,125874,,50614,42527,2.393853232935952,2.0106782868929374,0.3831749460430147,23.93853232935952,20.106782868929372,3.831749460430147
2021-01-27,2021-01-28 10:00,2104317,1738236,366081,2078798,1712717,366081,25519,25519,0,0,0,0,626219,524734,101485,996890,808545,188345,64357,53164,11193,692687,551912,140775,,49081,43106,2.5302395329785257,2.090062212511927,0.4401773204665987,25.302395329785256,20.900622125119266,4.401773204665987
2021-01-28,2021-01-29 10:00,2216127,1799481,416646,2183816,1767170,416646,32311,32311,0,0,0,0,679311,562252,117059,1020486,824488,195998,68079,54613,13466,713674,563329,150345,,50234,43878,2.66468034307621,2.1637034558214046,0.5009768872548056,26.6468034307621,21.637034558214044,5.009768872548056
2021-01-29,2021-01-30 10:00,2317158,1855457,461701,2283331,1821630,461701,33827,33827,0,0,0,0,721007,587512,133495,1066771,847611,219160,72549,56754,15795,736837,574393,162444,,54230,40064,2.7861604386399264,2.231009231566221,0.5551512070737052,27.861604386399264,22.310092315662214,5.551512070737052
2021-01-31,2021-02-01 10:00,2467918,1935356,532562,2432766,1900204,532562,35152,35152,0,0,0,0,844694,669993,174701,1132935,882574,250361,90795,69281,21514,772742,586806,185936,,30370,28007,2.9674348911068518,2.3270801222378505,0.640354768869001,29.674348911068517,23.270801222378505,6.40354768869001
2021-02-01,2021-02-02 10:00,2586997,1980211,606786,2550305,1943519,606786,36692,36692,0,0,0,0,888687,690209,198478,1212107,917012,295095,95611,71393,24218,811961,597821,214140,,38074,61862,3.110615977106513,2.381013961223019,0.7296020158834945,31.106159771065133,23.810139612230188,7.296020158834946
2021-02-02,2021-02-03 10:00,2713210,2033561,679649,2674451,1994802,679649,38759,38759,0,0,0,0,931158,708616,222542,1275365,945499,329866,100603,73639,26964,846119,607546,238573,,43725,61952,3.262375014445383,2.445162223620939,0.8172127908244442,32.62375014445383,24.45162223620939,8.172127908244441
2021-02-03,2021-02-04 10:00,2848022,2091689,756333,2805316,2049011,756305,42706,42678,28,0,0,0,979966,730066,249900,1341247,975000,366247,105349,75995,29354,878967,617241,261726,,44531,65548,3.4244735252305456,2.5150555731367086,0.9094179520938371,34.24473525230545,25.150555731367085,9.094179520938372
2021-02-04,2021-02-05 10:00,2987398,2153000,834398,2940357,2105968,834389,47041,47032,9,0,0,0,1027594,751469,276125,1412509,1008877,403632,110467,78284,32183,913990,626939,287051,,51518,65070,3.592059808641465,2.588776175121317,1.0032836335201472,35.92059808641465,25.887761751213176,10.032836335201473
2021-02-05,2021-02-06 10:00,3116122,2212851,903271,3063335,2160072,903263,52787,52779,8,0,0,0,1075736,774875,300861,1475216,1038877,436339,115246,79857,35389,943674,636362,307312,,49890,61132,3.7468380828478356,2.6607412670196853,1.0860968158281503,37.46838082847836,26.607412670196855,10.860968158281503
2021-02-07,2021-02-08 11:00,3277135,2295221,981914,3217237,2235333,981904,59898,59888,10,0,0,0,1109846,804580,305266,1581519,1082323,499196,119086,82750,36336,957042,649811,307231,,31063,23287,3.940440785256014,2.7597832983920694,1.1806574868639448,39.40440785256014,27.597832983920693,11.80657486863945
2021-02-08,2021-02-09 10:00,3369433,2344802,1024631,3305995,2281674,1024321,63423,63113,310,15,15,0,1154551,830292,324259,1618602,1101480,517122,122839,84612,38227,974298,657328,316970,,40764,41037,4.051420285214838,2.8193996994783164,1.2320205857365214,40.51420285214838,28.193996994783166,12.320205857365215
2021-02-09,2021-02-10 10:00,3509660,2405156,1104504,3442270,2338076,1104194,67337,67037,300,43,43,0,1236210,861298,374912,1653889,1124283,529606,131576,87448,44128,1031376,666234,365142,,56293,55744,4.2200298145732855,2.8919696006735194,1.3280602138997657,42.20029814573285,28.919696006735194,13.280602138997658
2021-02-10,2021-02-11 10:00,3669148,2490423,1178725,3591012,2413319,1177693,72139,71107,1032,5997,5997,0,1310973,913165,397808,1723296,1151641,571655,134898,89057,45841,1057352,676448,380904,,68425,59847,4.41179885062426,2.9944949969225068,1.4173038537017533,44.1179885062426,29.944949969225068,14.173038537017533
2021-02-11,2021-02-12 10:00,3810003,2556697,1253306,3714846,2465249,1249597,77326,73617,3709,17831,17831,0,1370105,947289,422816,1793017,1181513,611504,140279,91424,48855,1081059,683448,397611,,66629,65168,4.581163489800625,3.074183130796167,1.506980359004458,45.81163489800625,30.741831307961668,15.069803590044579
2021-02-12,2021-02-13 08:00,3967246,2635673,1331573,3848994,2526472,1322522,86967,77916,9051,31285,31285,0,1439745,988804,450941,1862990,1212616,650374,148734,93962,54772,1106636,692279,414357,,74727,72329,4.770233128492961,3.1691442024201244,1.601088926072837,47.70233128492961,31.691442024201244,16.01088926072837
2021-02-14,2021-02-15 08:00,4146348,2736109,1410239,4003104,2604659,1398445,93078,81284,11794,50166,50166,0,1531253,1045139,486114,1937161,1250732,686429,152898,96511,56387,1134231,702309,431922,,35766,26101,4.9855861199080005,3.2899088675034895,1.6956772524045107,49.85586119908,32.899088675034896,16.956772524045107
2021-02-15,2021-02-16 08:00,4284554,2813732,1470822,4122884,2665276,1457608,96801,83587,13214,64869,64869,0,1601858,1088756,513102,1993020,1279804,713216,157239,98955,58284,1155751,709593,446158,,68541,53247,5.151765590441589,3.3832430862872527,1.7685225041543364,51.51765590441589,33.83243086287253,17.685225041543365
2021-02-16,2021-02-17 10:00,4422007,2896064,1525943,4234503,2723359,1511144,99971,85172,14799,87533,87533,0,1671639,1134114,537525,2052134,1315447,736687,160091,100631,59460,1185005,724275,460730,,78592,52189,5.317039650636178,3.482239426301228,1.8348002243349506,53.17039650636178,34.82239426301228,18.348002243349505
2021-02-17,2021-02-18 08:00,4572420,2991792,1580628,4359311,2794969,1564342,106523,90237,16286,106586,106586,0,1750392,1189939,560453,2111016,1349583,761433,165065,103463,61602,1207414,733181,474233,,89940,51003,5.497896868856579,3.5973431725585496,1.9005536962980296,54.978968688565786,35.97343172558549,19.005536962980297
2021-02-18,2021-02-19 08:00,4719900,3085114,1634786,4477310,2860811,1616499,113569,95282,18287,129021,129021,0,1822587.988,1239020.988,583567,2165385.63,1381553.278,783832.352,168536,105299,63237,1229128,741437,487691,,88829,50299,5.675227435650305,3.7095539343860793,1.9656735012642257,56.75227435650305,37.09553934386079,19.656735012642258
2021-02-19,2021-02-20 08:00,4869641,3179290,1690351,4595777,2926650,1669127,122975,101751,21224,150889,150889,0,1909015.9139999999,1301878.9139999999,607137,2229283.4299999997,1419690.078,809593.352,176450,110381,66069,1261399,760490,500909,,89155,51336,5.855276638269367,3.8227915493736426,2.0324850888957244,58.55276638269367,38.22791549373643,20.32485088895724
2021-02-21,2021-02-22 08:00,5068829,3312351,1756478,4749455,3016589,1732866,132354,108742,23612,187020,187020,0,2026360,1388597,637763,2313783,1476574,837209,182480,113680,68800,1283699,766186,517513,,55986,28234,6.094781119816076,3.982784650459485,2.1119964693565914,60.947811198160764,39.82784650459485,21.119964693565915
2021-02-22,2021-02-23 08:00,5220336,3413730,1806606,4867212,3087374,1779838,141238,114470,26768,211886,211886,0,2104880,1446871,658009,2373468,1513677,859791,187391,116878,70513,1301584,772832,528752,,95229,44277,6.276953768196989,4.104683182673894,2.1722705855230946,62.769537681969894,41.046831826738945,21.72270585523095
2021-02-23,2021-02-24 08:00,5373222,3518294,1854928,4987095,3160936,1826159,147571,118802,28769,238556,238556,0,2180808,1503334,677474,2435309,1552902,882407,192678,120068,72610,1320103,780493,539610,,98934,44203,6.460784531926482,4.230411372165481,2.230373159761001,64.60784531926483,42.30411372165481,22.30373159761001
2021-02-24,2021-02-25 08:00,5544145,3633282,1910863,5118081,3237993,1880088,155078,124303,30775,270986,270986,0,2265314,1566885,698429,2508039,1597085,910954,198913,124153,74760,1338349,788183,550166,,110360,48449,6.666303059646064,4.368673422711161,2.297629636934903,66.66303059646064,43.686734227111614,22.97629636934903
2021-02-25,2021-02-26 10:00,5730949,3759906,1971043,5255195,3316427,1938768,161186,128911,32275,314568,314568,0,2347764,1630415,717349,2601710,1655475,946235,206225,129438,76787,1354505,795102,559403,,116880,42536,6.890916967968109,4.52092664816335,2.369990319804759,68.9091696796811,45.2092664816335,23.699903198047593
2021-02-26,2021-02-27 08:00,5910537,3881490,2029047,5378703,3383521,1995182,168189,134324,33865,363645,363645,0,2424992,1686392,738600,2686407,1710096,976311,213133,134479,78654,1373246,803644,569602,,114645,49577,7.106854327809116,4.6671197566055005,2.439734571203615,71.06854327809116,46.67119756605501,24.397345712036152
2021-02-28,2021-03-01 08:00,6174362,4079107,2095255,5543772,3483481,2060291,175981,141017,34964,454609,454609,0,2530429,1764839,765590,2810867,1804185,1006682,221794,142398,79396,1388364,808620,579744,,80564,26455,7.4240786076053915,4.904735261203248,2.519343346402144,74.24078607605392,49.047352612032476,25.19343346402144
2021-03-01,2021-03-02 08:00,6394364,4234952,2159412,5696093,3573626,2122467,183845,146900,36945,514426,514426,0,2641523,1846314,795209,2904241,1869392,1034849,230716,149628,81088,1404669,813771,590898,,133340,47299,7.688609929518555,5.0921239388678,2.5964859906507547,76.88609929518555,50.921239388678,25.964859906507545
