date,publication_date,dosen_kumulativ,personen_erst_kumulativ,personen_voll_kumulativ,dosen_biontech_kumulativ,dosen_erst_biontech_kumulativ,dosen_voll_biontech_kumulativ,dosen_moderna_kumulativ,dosen_erst_moderna_kumulativ,dosen_voll_moderna_kumulativ,dosen_astrazeneca_kumulativ,dosen_erst_astrazeneca_kumulativ,dosen_voll_astrazeneca_kumulativ,indikation_alter_dosen,indikation_alter_erst,indikation_alter_voll,indikation_beruf_dosen,indikation_beruf_erst,indikation_beruf_voll,indikation_medizinisch_dosen,indikation_medizinisch_erst,indikation_medizinisch_voll,indikation_pflegeheim_dosen,indikation_pflegeheim_erst,indikation_pflegeheim_voll,dosen_differenz_zum_vortag,dosen_erst_differenz_zum_vortag,dosen_voll_differenz_zum_vortag,impf_quote_dosen,impf_quote_erst,impf_quote_voll,impf_inzidenz_dosen,impf_inzidenz_erst,impf_inzidenz_voll
2020-12-27,2020-12-28 16:15,182,182,0,182,182,0,0,0,0,0,0,0,90,90,0,69,69,0,0,0,0,113,113,0,,,,0.004469579965083248,0.004469579965083248,0,0.044695799650832486,0.044695799650832486,0
2020-12-28,2020-12-29 08:00,857,857,0,857,857,0,0,0,0,0,0,0,240,240,0,551,551,0,1,1,0,305,305,0,675,,,0.021046318846573316,0.021046318846573316,0,0.21046318846573317,0.21046318846573317,0
2020-12-30,2020-12-31 08:30,2653,2653,0,2653,2653,0,0,0,0,0,0,0,150,150,0,2460,2460,0,1,1,0,192,192,0,1166,,,0.06515272333717505,0.06515272333717505,0,0.6515272333717504,0.6515272333717504,0
2020-12-31,2021-01-01 12:30,3290,3290,0,3290,3290,0,0,0,0,0,0,0,226,226,0,2754,2754,0,1,1,0,535,535,0,637,,,0.08079625321496642,0.08079625321496642,0,0.8079625321496642,0.8079625321496642,0
2021-01-01,2021-01-02 08:00,4000,4000,0,4000,4000,0,0,0,0,0,0,0,297,297,0,3320,3320,0,1,1,0,679,679,0,710,,,0.09823252670512633,0.09823252670512633,0,0.9823252670512633,0.9823252670512633,0
2021-01-02,2021-01-03 08:00,4343,4343,0,4343,4343,0,0,0,0,0,0,0,368,368,0,3535,3535,0,1,1,0,807,807,0,343,,,0.10665596587009092,0.10665596587009092,0,1.0665596587009092,1.0665596587009092,0
2021-01-03,2021-01-04 12:00,4866,4866,0,4866,4866,0,0,0,0,0,0,0,487,487,0,3765,3765,0,1,1,0,1100,1100,0,523,,,0.1194998687367862,0.1194998687367862,0,1.194998687367862,1.194998687367862,0
2021-01-04,2021-01-05 12:00,7740,7740,0,7740,7740,0,0,0,0,0,0,0,662,662,0,6354,6354,0,1,1,0,1385,1385,0,2874,,,0.19007993917441945,0.19007993917441945,0,1.9007993917441945,1.9007993917441948,0
2021-01-05,2021-01-06 11:00,10767,10767,0,10767,10767,0,0,0,0,0,0,0,820,820,0,8945,8945,0,1,1,0,1821,1821,0,3027,,,0.2644174037585238,0.2644174037585238,0,2.644174037585238,2.6441740375852385,0
2021-01-06,2021-01-07 11:00,13006,13006,0,13006,13006,0,0,0,0,0,0,0,858,858,0,11072,11072,0,1,1,0,1933,1933,0,2239,,,0.3194030605817183,0.3194030605817183,0,3.194030605817183,3.194030605817183,0
2021-01-07,2021-01-08 11:00,15593,15593,0,15593,15593,0,0,0,0,0,0,0,985,985,0,13343,13343,0,1,1,0,2249,2249,0,2587,,,0.38293494722825877,0.38293494722825877,0,3.8293494722825874,3.8293494722825874,0
2021-01-08,2021-01-09 11:00,17991,17991,0,17991,17991,0,0,0,0,0,0,0,1024,1024,0,15283,15283,0,1,1,0,2707,2707,0,2398,,,0.441825346987982,0.441825346987982,0,4.4182534698798195,4.4182534698798195,0
2021-01-10,2021-01-11 11:00,19756,19756,0,19756,19756,0,0,0,0,0,0,0,1357,1357,0,16051,16051,0,1,1,0,3704,3704,0,715,,,0.48517044939661896,0.48517044939661896,0,4.8517044939661895,4.85170449396619,0
2021-01-11,2021-01-12 11:00,23701,23701,0,23701,23701,0,0,0,0,0,0,0,1805,1805,0,19173,19173,0,1,1,0,4527,4527,0,3945,,,0.5820522788595498,0.5820522788595498,0,5.820522788595499,5.820522788595499,0
2021-01-12,2021-01-13 11:00,29421,29421,0,29421,29421,0,0,0,0,0,0,0,2210,2210,0,23650,23650,0,1,1,0,5770,5770,0,5720,,,0.7225247920478804,0.7225247920478804,0,7.225247920478805,7.225247920478805,0
2021-01-13,2021-01-14 11:00,34588,34588,0,34588,34588,0,0,0,0,0,0,0,2528,2528,0,27920,27920,0,1,1,0,6667,6667,0,5167,,,0.8494166584192274,0.8494166584192274,0,8.494166584192275,8.494166584192273,0
2021-01-14,2021-01-15 11:00,39332,39332,0,39332,39332,0,0,0,0,0,0,0,3005,3005,0,31443,31443,0,1,1,0,7888,7888,0,4744,,,0.9659204350915073,0.9659204350915073,0,9.659204350915072,9.659204350915072,0
2021-01-15,2021-01-16 11:00,43451,43451,0,43451,43451,0,0,0,0,0,0,0,3555,3555,0,34444,34444,0,1,1,0,9006,9006,0,4119,,,1.0670753794661112,1.0670753794661112,0,10.670753794661112,10.670753794661112,0
2021-01-17,2021-01-18 11:00,50157,50002,155,50157,50002,155,0,0,0,0,0,0,4344,4303,41,38885,38835,50,1,1,0,11271,11166,105,,3019,155,1.2317622104872554,1.2279557000774317,0.0038065104098236454,12.317622104872555,12.279557000774318,0.038065104098236456
2021-01-18,2021-01-19 14:00,54031,53663,368,54031,53663,368,0,0,0,0,0,0,4598,4539,59,41668,41461,207,1,1,0,12362,12201,161,,3661,,1.3269004126011703,1.3178630201442987,0.009037392456871624,13.269004126011703,13.178630201442987,0.09037392456871624
2021-01-19,2021-01-20 10:00,59715,58576,1139,59715,58576,1139,0,0,0,0,0,0,5342,5283,59,45683,44705,978,1,1,0,14031,13870,161,,4913,771,1.4664888330491548,1.43851712106987,0.027971711979284726,14.664888330491548,14.3851712106987,0.27971711979284725
2021-01-20,2021-01-21 10:00,64677,62126,2551,64677,62126,2551,0,0,0,0,0,0,5762,5703,59,49483,47093,2390,1,1,0,15193,15032,161,,3550,1412,1.588346282426864,1.5256984885206697,0.06264779390619432,15.88346282426864,15.256984885206696,0.6264779390619433
2021-01-21,2021-01-22 10:00,68071,64728,3343,68071,64728,3343,0,0,0,0,0,0,6115,5995,120,51837,48854,2983,1,1,0,16233,15873,360,,2602,792,1.6716965813361637,1.5895987471423543,0.08209783419380934,16.716965813361636,15.895987471423544,0.8209783419380934
2021-01-22,2021-01-23 10:00,71152,67357,3795,71053,67258,3795,99,99,0,0,0,0,6115,5995,120,51837,48854,2983,1,1,0,17469,16873,596,,2629,452,1.7473601850307874,1.6541620753192987,0.09319810971148862,17.473601850307872,16.541620753192987,0.9319810971148861
2021-01-24,2021-01-25 10:00,75882,71283,4599,75693,71094,4599,189,189,0,0,0,0,7523,7213,310,55945,52147,3798,152,152,0,19785,18984,801,,1650,527,1.8635201478595993,1.7505773002803802,0.112942847579219,18.63520147859599,17.505773002803803,1.12942847579219
2021-01-25,2021-01-26 10:00,80086,73723,6363,79897,73534,6363,189,189,0,0,0,0,8018,7525,493,58642,53731,4911,152,152,0,21292,19840,1452,,2440,1764,1.966762533426687,1.8104991415705072,0.1562633918561797,19.66762533426687,18.104991415705072,1.5626339185617972
2021-01-26,2021-01-27 10:00,86187,77181,9006,85998,76992,9006,189,189,0,0,0,0,8593,7892,701,63026,56037,6989,152,152,0,23009,20992,2017,,3458,2643,2.116591694783681,1.895421160907089,0.22117053387659194,21.16591694783681,18.95421160907089,2.2117053387659196
2021-01-27,2021-01-28 10:00,90025,79507,10518,89659,79141,10518,366,366,0,0,0,0,9076,8318,758,64405,56074,8331,152,152,0,23009,20992,2017,,2326,1512,2.2108458041572496,1.95254337518612,0.2583024289711297,22.108458041572497,19.5254337518612,2.583024289711297
2021-01-28,2021-01-29 10:00,94100,82046,12054,93454,81400,12054,646,646,0,0,0,0,9510,8710,800,67050,57311,9739,229,229,0,24175,22030,2145,,2539,1536,2.310920190738097,2.014896471512199,0.2960237192258982,23.10920190738097,20.148964715121988,2.9602371922589823
2021-01-29,2021-01-30 10:00,98250,84339,13911,97322,83411,13911,928,928,0,0,0,0,10229,9337,892,68686,57784,10902,464,456,8,24544,22307,2237,,2293,1857,2.412836437194666,2.071208267445913,0.3416281697487531,24.128364371946656,20.712082674459126,3.4162816974875314
2021-01-31,2021-02-01 10:00,105841,89519,16322,104798,88476,16322,1043,1043,0,0,0,0,12769,11599,1170,71498,59494,12004,841,600,241,25999,23358,2641,,2575,1247,2.5992572147493194,2.198419389529051,0.400837825220268,25.992572147493192,21.984193895290513,4.0083782522026805
2021-02-01,2021-02-02 10:00,112217,92418,19799,111119,91320,19799,1098,1098,0,0,0,0,14418,12983,1435,74677,60467,14210,1358,950,408,26631,23848,2783,,2899,3477,2.7558398623172904,2.2696134132585915,0.4862264490586991,27.558398623172906,22.696134132585915,4.862264490586991
2021-02-02,2021-02-03 10:00,119455,95470,23985,118217,94232,23985,1238,1238,0,0,0,0,16432,14395,2037,78512,61549,16963,1995,1352,643,27761,24365,3396,,3052,4186,2.9335916193902167,2.344564831134603,0.5890267882556138,29.335916193902168,23.44564831134603,5.890267882556138
2021-02-03,2021-02-04 10:00,126570,98202,28368,124688,96320,28368,1882,1882,0,0,0,0,18087,15375,2712,81920,62163,19757,2676,1675,1001,28654,24689,3965,,2732,4383,3.10832272626696,2.4116576468742044,0.6966650793927559,31.083227262669602,24.116576468742043,6.96665079392756
2021-02-04,2021-02-05 10:00,133117,100862,32255,130921,98666,32255,2196,2196,0,0,0,0,19714,16314,3400,84991,62981,22010,3417,2040,1377,29741,25219,4522,,2660,3887,3.2691048143515755,2.476982277133113,0.7921225372184626,32.69104814351576,24.769822771331132,7.921225372184625
2021-02-05,2021-02-06 10:00,140089,104150,35939,137821,101882,35939,2268,2268,0,0,0,0,22026,17890,4136,87979,63887,24092,4109,2239,1870,30610,25668,4942,,3288,3684,3.440324108398611,2.557729414084727,0.8825946943138839,34.40324108398611,25.577294140847272,8.825946943138838
2021-02-07,2021-02-08 11:00,150731,108634,42097,148336,106239,42097,2395,2395,0,0,0,0,26215,19854,6361,91933,65449,26484,4859,2442,2417,32383,26698,5685,,2176,2724,3.7016717456975994,2.6678480765211736,1.033823669176426,37.016717456976,26.678480765211738,10.338236691764259
2021-02-08,2021-02-09 10:00,156889,111700,45189,154180,108991,45189,2709,2709,0,0,0,0,28727,20993,7734,93730,66354,27376,5533,2843,2690,33263,27209,6054,,3066,3092,3.8529007205601413,2.7431433082406533,1.1097574123194887,38.52900720560142,27.43143308240653,11.097574123194885
2021-02-09,2021-02-10 10:00,164454,115273,49181,161350,112169,49181,3104,3104,0,0,0,0,32573,23046,9527,96104,67303,28801,6247,3258,2989,34507,27692,6815,,3573,3992,4.038682986691212,2.830889512720007,1.2077934739712046,40.386829866912116,28.30889512720007,12.077934739712045
2021-02-10,2021-02-11 10:00,170296,117961,52335,166939,114604,52335,3357,3357,0,0,0,0,35631,24328,11303,97930,68043,29887,6668,3436,3232,35530,28118,7412,,2688,3154,4.182151591944049,2.8969017706658517,1.2852498212781969,41.821515919440486,28.96901770665852,12.852498212781967
2021-02-11,2021-02-12 10:00,175426,120860,54566,171878,117312,54566,3548,3548,0,0,0,0,38384,25944,12440,99521,68838,30683,6920,3511,3409,36331,28548,7783,,2899,2231,4.308134807443373,2.968095794395392,1.340039013047981,43.081348074433734,29.680957943953924,13.40039013047981
2021-02-12,2021-02-13 08:00,181302,123971,57331,177599,120268,57331,3703,3703,0,0,0,0,41136,27575,13561,101358,69691,31667,7384,3840,3544,37490,28976,8514,,3111,2765,4.452438389173204,3.044496142040304,1.4079422471328995,44.524383891732036,30.444961420403043,14.079422471328995
2021-02-14,2021-02-15 08:00,190994,129439,61555,185989,124434,61555,4461,4461,0,544,544,0,45986,30496,15490,104782,71260,33522,7904,4081,3823,39056,29723,9333,,2612,1554,4.690455801379725,3.178780006046212,1.511675795333513,46.90455801379725,31.78780006046212,15.11675795333513
2021-02-15,2021-02-16 08:00,196975,132582,64393,191162,126769,64393,5029,5029,0,784,784,0,48955,32278,16677,106787,72051,34736,8219,4223,3996,40116,30112,10004,,3143,2838,4.837337986935565,3.255966213904765,1.5813717730308,48.37337986935565,32.55966213904765,15.813717730308001
2021-02-16,2021-02-17 10:00,202616,135382,67234,196252,129018,67234,5385,5385,0,979,979,0,51932,33925,18007,108052,72799,35253,8457,4359,4098,40490,30299,10191,,2800,2841,4.9758704077214695,3.3247289825983537,1.651141425123116,49.758704077214695,33.247289825983536,16.51141425123116
2021-02-17,2021-02-18 08:00,209124,139917,69207,201953,132746,69207,5890,5890,0,1281,1281,0,56390,37587,18803,109621,73484,36137,8842,4556,4286,41172,30489,10683,,4535,1973,5.13569472867071,3.4361001097502903,1.6995946189204196,51.356947286707104,34.36100109750291,16.995946189204197
2021-02-18,2021-02-19 08:00,216003,144601,71402,208038,136636,71402,6333,6333,0,1632,1632,0,61095,41160,19935,111314,74368,36946,9272,4845,4427,42121,30730,11391,,4684,2195,5.304630116471851,3.5511303985219933,1.7534997179498575,53.046301164718514,35.51130398521993,17.53499717949858
2021-02-19,2021-02-20 08:00,224101,150611,73490,214990,141591,73399,7050,6959,91,2061,2061,0,66646,45718,20928,113060,75326,37734,9831,5193,4638,43046,31184,11862,,6010,2088,5.5035018667863795,3.6987247698964456,1.8047770968899337,55.035018667863795,36.98724769896446,18.047770968899336
2021-02-21,2021-02-22 08:00,243116,164736,78380,231526,153419,78107,8370,8097,273,3220,3220,0,78024,54878,23146,117088,77582,39506,10424,5570,4854,44998,31961,13037,,6618,2752,5.970474740610873,4.045608379823923,1.9248663607869507,59.70474740610874,40.456083798239234,19.248663607869506
2021-02-22,2021-02-23 08:00,252105,170912,81193,239896,158976,80920,8667,8394,273,3542,3542,0,83533,59147,24386,119163,78702,40461,10905,5748,5157,45903,32406,13497,,6176,2813,6.191227786248969,4.1972794010566385,1.9939483851923308,61.91227786248969,41.97279401056638,19.939483851923306
2021-02-23,2021-02-24 08:00,262470,178860,83610,250033,166696,83337,8853,8580,273,3584,3584,0,88768,63096,25672,122209,80737,41472,11490,6015,5475,47118,32994,14124,,7948,2417,6.445772821073628,4.392467431619724,2.0533053894539033,64.45772821073628,43.92467431619724,20.533053894539034
2021-02-24,2021-02-25 08:00,269964,184278,85686,256556,171212,85344,9401,9059,342,4007,4007,0,93291,66598,26693,124499,82239,42260,11816,6141,5675,47957,33404,14553,,5418,2076,6.629811459855682,4.525523389041817,2.1042880708138636,66.29811459855682,45.255233890418175,21.04288070813864
2021-02-25,2021-02-26 10:00,278919,190984,87935,264231,176722,87509,9917,9491,426,4771,4771,0,98459,70787,27672,127146,84041,43105,12118,6323,5795,48747,33679,15068,,6706,2249,6.849729529016783,4.690210220062962,2.159519308953821,68.49729529016783,46.90210220062962,21.59519308953821
2021-02-26,2021-02-27 08:00,289899,198564,91335,273351,182784,90567,10692,9924,768,5856,5856,0,104226,74947,29279,130092,86039,44053,12719,6516,6203,49541,33980,15561,,7580,3400,7.119377814822355,4.876360858169177,2.243016956653179,71.19377814822354,48.76360858169176,22.430169566531784
2021-02-28,2021-03-01 08:00,307915,212333,95582,288332,193518,94814,11606,10838,768,7977,7977,0,104226,74947,29279,130092,86039,44053,12719,6516,6203,49541,33980,15561,,6951,1986,7.561817115102244,5.214501773219897,2.3473153418823465,75.61817115102244,52.14501773219898,23.473153418823465
2021-03-01,2021-03-02 08:00,316711,218717,97994,295228,198054,97174,11904,11084,820,9579,9579,0,109199,78693,30506,133161,88195,44966,13385,7033,6352,50015,33980,16035,,6384,2412,7.777830441326817,5.371280885841279,2.4065495554855376,77.77830441326817,53.71280885841279,24.065495554855374
2021-03-02,2021-03-03 10:00,327648,226750,100898,304660,204692,99968,12197,11267,930,10791,10791,0,125250,91165,34085,142029,94514,47515,14922,8263,6659,51463,33984,17479,,8033,2904,8.046422727470308,5.56855635759685,2.4778663698734595,80.46422727470309,55.685563575968494,24.778663698734594
2021-03-03,2021-03-04 08:00,338948,235347,103601,314073,211510,102563,12632,11594,1038,12243,12243,0,130823,95415,35408,144640,96391,48249,15717,8918,6799,51922,33984,17938,,8597,2703,8.32392961541229,5.779682615617842,2.5442469997944483,83.23929615412291,57.79682615617842,25.442469997944485
2021-03-04,2021-03-05 08:00,350765,244306,106459,323005,217891,105114,13340,11995,1345,14420,14420,0,136120,99351,36769,147306,98240,49066,16638,9666,6972,52308,33984,18324,,8959,2858,8.61413305743091,5.999698917305649,2.6144341401252613,86.1413305743091,59.99698917305649,26.14434140125261
2021-03-05,2021-03-06 08:00,359002,249966,109036,329492,221884,107608,13589,12161,1428,15921,15921,0,140258,102288,37970,150194,100224,49970,17550,10371,7179,52848,33986,18862,,5660,2577,8.816418388048442,6.138697942593403,2.677720445455039,88.16418388048442,61.38697942593402,26.77720445455039
2021-03-07,2021-03-08 08:00,380453,266909,113544,345961,233928,112033,14198,12687,1511,20294,20294,0,148454,108272,40182,155383,104335,51048,19446,11992,7454,53561,33988,19573,,9404,2151,9.343214870636357,6.554786367584642,2.7884285030517164,93.43214870636358,65.54786367584641,27.884285030517162
2021-03-08,2021-03-09 08:00,390539,274581,115958,354006,239636,114370,14331,12743,1588,22202,22202,0,153484,111965,41519,158248,106566,51682,20448,12894,7554,53925,33991,19934,,7672,2414,9.590908186723334,6.743196353805074,2.84771183291826,95.90908186723334,67.43196353805074,28.4771183291826
2021-03-09,2021-03-10 08:00,400780,282921,117859,362253,246046,116207,14438,12786,1652,24089,24089,0,158271,115558,42713,161432,109277,52155,21565,13862,7703,54123,33993,20130,,8340,1901,9.842408013220133,6.948011171985262,2.894396841234871,98.42408013220134,69.48011171985262,28.943968412348713
2021-03-10,2021-03-11 08:00,410939,289566,121373,370427,250774,119653,14586,12866,1720,25926,25926,0,163451,118041,45410,164353,111831,52522,22594,14775,7819,54268,33994,20274,,6645,3514,10.091894072919478,7.111199956974152,2.980694115945325,100.91894072919479,71.11199956974153,29.80694115945325
2021-03-11,2021-03-12 08:00,421766,296334,125432,378432,254908,123524,14836,12928,1908,28498,28498,0,168113,119726,48387,167466,114337,53129,23997,15919,8078,54519,33995,20524,,6768,4059,10.35778496457858,7.277409392159227,3.0803755724193516,103.57784964578579,72.77409392159227,30.80375572419352
2021-03-12,2021-03-13 08:00,433217,303146,130071,386094,258048,128046,15214,13189,2025,31909,31909,0,173406,121524,51882,170509,116842,53667,25857,17551,8306,54940,33995,20945,,6812,4639,10.63900013040368,7.4446993851380565,3.1943007452656222,106.39000130403679,74.44699385138057,31.94300745265622
2021-03-14,2021-03-15 08:00,454151,313493,140658,400099,261632,138467,16244,14053,2191,37808,37808,0,183930,124235,59695,175609,120387,55222,28196,19500,8696,55558,33995,21563,,5212,5512,11.153100058914958,7.698802373592543,3.454297685322415,111.53100058914958,76.98802373592542,34.542976853224154
2021-03-15,2021-03-16 08:00,463529,317780,145749,406395,263186,143209,16776,14236,2540,40358,40358,0,188777,125269,63508,178373,122045,56328,29758,20874,8884,55948,33995,21953,,4287,5091,11.383406217775127,7.804083084088761,3.579323133686365,113.83406217775126,78.04083084088762,35.79323133686365
2021-03-16,2021-03-17 08:00,473092,319475,153617,415267,264668,150599,17467,14449,3018,40358,40358,0,195206,125993,69213,181362,122997,58365,30310,21188,9122,56457,33995,22462,,1695,7868,11.618255630995407,7.845709117280059,3.772546513715348,116.18255630995408,78.45709117280059,37.725465137153485
2021-03-17,2021-03-18 08:00,480134,321033,159101,421124,265487,155637,18652,15188,3464,40358,40358,0,200109,126616,73493,183505,123949,59556,30467,21247,9220,56868,33995,22873,,1558,5484,11.791193994259782,7.883970686431706,3.907223307828076,117.91193994259783,78.83970686431707,39.07223307828076
2021-03-18,2021-03-19 08:00,487152,322049,165103,427243,266034,161209,19551,15657,3894,40358,40358,0,205394,127219,78175,185106,124280,60826,30706,21343,9363,57121,33995,23126,,1016,6002,11.963542962363926,7.908921748214808,4.054621214149119,119.63542962363927,79.08921748214809,40.54621214149118
2021-03-19,2021-03-20 08:00,495803,324203,171600,433914,266703,167211,20591,16202,4389,41298,41298,0,211061,127990,83071,186883,124845,62038,31565,22085,9480,57443,33995,23448,,2154,6497,12.175995359495438,7.961819963845519,4.21417539564992,121.75995359495438,79.61819963845518,42.1417539564992
2021-03-21,2021-03-22 08:00,513132,330616,182516,445000,268071,176929,22534,16947,5587,45598,45598,0,221640,130124,91516,190163,126311,63852,32845,23046,9799,57452,33995,23457,,2963,5386,12.601563223313722,8.119311262285512,4.48225196102821,126.01563223313723,81.19311262285512,44.8225196102821
